15
............o..
......o....o...
...............
...............
....o.......o..
..............o
...............
.o.............
..o............
........o......
...............
...............
....o..o.......
.......o.......
...............
