8
.......o
....o..o
....o...
........
......o.
....o...
.......o
........
